1 1 1 1 1 1 1 1 1 1 1 0 0 0 0 0 4 4 4 4 4 4 4 4 4 4 4 4 4 4 4 4 0 0 0 0 0 0 0 0 0 5 5 2 2 2 2 2 2 2
1 6 6 6 6 6 6 6 6 6 1 0 0 0 0 0 0 4 4 4 4 4 4 4 4 4 4 4 4 4 4 4 0 0 0 0 0 0 0 0 0 5 2 2 2 2 2 2 2 2
1 6 6 6 6 6 6 6 6 6 1 0 0 0 0 0 0 0 4 4 4 7 0 8 8 7 4 4 4 4 4 4 0 0 0 0 0 0 0 0 5 5 2 2 2 2 2 2 2 2
1 6 6 6 6 6 6 6 6 6 1 0 0 0 0 0 0 0 4 4 7 8 0 0 0 8 4 4 4 4 0 0 0 0 0 0 0 0 0 5 5 2 2 2 2 2 2 2 2 5
1 6 6 6 6 6 6 6 6 6 1 0 0 0 0 0 0 0 4 4 4 8 8 8 7 4 4 4 4 4 0 0 0 0 0 0 0 0 0 5 2 2 2 2 2 2 2 5 5 5
1 6 6 6 6 6 6 6 6 6 1 0 0 0 0 0 0 0 4 4 4 8 8 0 4 4 4 4 4 0 0 0 0 0 0 0 0 0 5 5 2 2 2 2 2 2 2 5 5 5
1 6 6 6 6 6 6 6 6 6 1 0 0 0 0 0 0 0 0 4 4 4 8 0 4 4 4 4 0 0 0 0 0 0 0 0 0 0 5 5 2 2 2 2 2 2 2 5 5 5
1 1 1 1 1 6 1 1 1 1 1 0 0 0 0 0 0 0 0 0 4 4 4 0 4 4 4 0 0 0 0 0 0 0 0 7 0 8 8 5 2 2 2 2 2 2 5 5 0 0
0 1 6 6 6 6 6 6 1 0 0 0 0 0 0 0 0 0 0 0 0 4 4 0 4 4 4 0 0 0 0 0 0 0 0 0 8 8 8 5 5 5 2 2 2 2 5 0 0 0
0 1 6 6 6 6 6 6 1 0 0 0 0 0 0 0 0 0 0 0 0 0 0 0 0 0 0 0 0 0 0 0 0 0 5 5 5 8 8 8 8 5 2 2 5 5 5 0 0 0
0 1 6 6 6 6 6 6 1 0 0 0 0 0 0 7 0 0 0 0 0 7 0 0 0 0 0 0 0 0 0 0 5 5 5 5 5 5 5 8 8 5 5 5 5 0 0 0 0 0
0 1 6 6 6 6 6 6 1 0 0 0 0 0 0 0 0 0 0 0 0 0 0 0 0 0 0 0 0 0 0 5 5 5 5 5 2 2 5 5 8 8 5 5 0 0 0 0 0 0
0 1 6 6 6 6 6 6 1 0 0 0 0 0 0 0 0 0 0 0 0 0 0 0 0 0 7 0 0 0 5 5 5 5 5 5 2 2 5 5 5 8 8 8 0 0 0 0 0 0
0 1 6 6 6 6 6 6 1 0 0 0 7 0 0 0 0 0 0 0 0 0 0 0 0 0 0 0 0 5 5 5 5 5 5 2 2 2 2 5 5 5 0 8 0 0 0 0 0 0
0 1 1 1 1 6 1 1 1 0 0 0 0 0 0 0 0 0 0 0 7 0 0 0 0 0 0 0 0 5 5 5 5 2 2 2 2 2 2 5 5 5 0 0 0 0 0 0 0 0
0 0 0 0 0 0 0 0 0 0 0 0 0 0 0 0 0 0 0 0 0 0 0 0 0 0 0 0 0 5 5 5 5 2 2 2 2 2 2 2 5 5 5 0 0 0 0 0 0 0
0 0 0 0 0 0 0 0 0 0 0 0 0 0 0 0 0 0 0 0 0 0 0 0 0 0 0 0 5 5 5 5 2 2 2 2 2 2 2 2 5 5 0 0 0 0 0 0 0 0
0 0 0 0 0 0 0 0 0 0 0 0 0 0 0 0 0 0 0 0 0 0 0 0 0 0 0 0 5 5 5 5 2 2 2 2 2 2 2 2 5 5 0 0 0 0 0 0 0 0
0 0 0 0 0 0 0 0 0 0 0 0 0 0 0 0 7 0 0 0 0 0 0 0 0 0 5 5 5 5 5 2 2 2 2 2 2 2 2 2 5 5 0 0 0 0 0 0 0 0
0 0 0 0 0 0 0 0 0 0 0 0 0 0 0 0 0 0 0 0 0 0 0 0 0 5 5 5 5 5 5 2 2 2 2 2 2 2 2 2 5 5 0 0 0 0 0 4 4 4
0 0 0 0 0 0 0 0 7 0 0 0 0 0 0 0 0 0 0 0 0 0 0 0 0 5 5 5 5 5 5 2 2 2 2 2 2 2 2 2 5 5 0 0 0 0 4 4 4 4
0 0 0 0 0 0 0 0 0 0 0 0 0 0 0 0 0 0 0 0 0 0 0 0 0 5 5 5 5 5 5 2 2 2 2 2 2 2 2 2 5 5 0 0 0 0 4 4 4 4
0 0 0 0 0 0 0 0 0 0 0 0 0 0 0 0 0 0 0 0 0 0 0 0 5 5 5 5 5 5 5 2 2 2 2 2 2 2 2 5 5 0 0 0 0 4 4 4 4 4
0 0 0 3 3 3 3 3 3 3 3 3 0 0 0 0 0 0 0 0 0 0 0 5 5 5 5 5 5 5 5 2 2 2 2 2 2 2 2 5 5 0 0 0 0 4 4 4 4 4
0 0 0 3 3 3 3 3 3 3 3 3 3 0 0 0 0 0 0 0 0 0 0 5 5 5 5 5 5 5 2 2 2 2 2 2 2 2 2 5 5 0 0 0 0 4 4 4 4 4
0 0 0 3 3 3 3 3 3 3 3 3 3 0 0 0 0 0 0 0 0 0 5 5 5 5 5 5 2 2 2 2 2 2 2 2 2 2 2 5 0 0 0 0 0 4 4 4 4 4
3 3 3 3 3 3 3 3 3 3 3 3 3 0 0 0 0 0 0 0 5 5 5 5 5 5 5 5 2 2 2 2 2 2 2 2 2 2 2 0 0 0 0 0 4 4 4 4 4 4
3 3 3 3 3 3 3 3 3 3 3 3 3 0 0 7 0 0 0 0 5 5 5 5 5 5 5 5 2 2 2 2 2 2 2 2 2 2 2 0 0 0 0 0 4 4 4 4 4 4
3 3 3 3 3 3 3 3 3 3 3 3 3 0 0 0 0 0 0 5 5 5 5 5 5 2 2 2 2 2 2 2 2 2 2 2 2 2 0 0 0 0 0 0 4 4 4 4 4 4
3 3 3 3 3 3 3 3 3 3 3 3 3 0 0 0 0 0 0 5 5 5 5 2 2 2 2 2 2 2 2 2 2 2 2 2 2 0 0 0 0 0 0 0 4 4 4 4 4 4
3 3 3 3 3 3 3 3 3 3 3 3 3 0 0 0 0 0 5 5 5 5 5 2 2 2 2 2 2 2 2 2 2 2 2 0 0 0 0 0 0 0 0 0 4 4 4 4 4 4
3 3 3 3 3 3 3 3 3 3 3 3 3 0 0 0 0 0 5 5 5 5 2 2 2 2 2 2 2 2 2 2 2 2 0 0 0 0 0 0 0 0 0 0 0 4 4 4 4 4
3 3 3 3 3 3 3 3 3 3 3 3 3 0 0 0 0 0 5 5 5 5 2 2 2 2 2 2 2 2 2 2 2 0 0 0 0 0 0 0 0 0 0 0 0 4 4 4 4 4
3 3 3 3 3 3 3 3 3 3 3 3 3 0 0 7 0 5 5 5 5 2 2 2 2 2 2 2 2 2 2 2 0 0 0 0 7 0 0 0 0 0 0 0 0 4 4 4 4 4
3 3 3 3 3 3 3 3 3 3 3 3 3 0 0 0 5 5 5 5 5 2 2 2 2 2 2 2 2 2 2 0 0 0 0 0 0 0 0 0 0 0 0 0 0 4 4 4 4 4
0 3 3 3 3 3 3 3 3 3 3 3 0 0 0 0 5 5 5 5 5 2 2 2 2 2 2 2 2 2 0 0 0 0 0 0 0 0 0 0 0 0 0 0 0 4 4 4 4 4
0 3 3 3 3 3 3 4 4 4 3 3 0 0 0 0 5 5 5 5 2 2 2 2 2 2 2 2 2 2 0 0 0 0 0 0 0 0 0 0 0 0 0 0 4 4 4 4 4 4
0 3 4 4 4 4 4 4 4 4 0 0 0 0 0 0 5 5 5 5 2 2 2 2 2 2 2 2 2 2 0 0 0 0 0 0 0 0 0 0 0 0 0 0 4 4 4 4 4 4
0 3 4 4 4 4 4 4 4 4 0 0 0 0 7 0 5 5 5 5 2 2 2 2 2 2 2 2 2 0 0 0 0 0 0 0 0 0 0 4 4 4 4 4 4 4 4 4 4 4
0 0 4 4 4 4 4 4 4 4 0 0 0 0 0 0 5 5 5 5 2 2 2 2 2 2 2 2 2 0 0 0 0 0 0 0 0 0 4 4 4 4 4 4 4 4 4 4 4 4
0 0 4 4 4 4 4 4 0 0 0 0 0 0 0 0 0 2 2 2 2 2 2 2 2 2 2 2 2 0 0 0 0 0 0 0 0 0 4 4 4 4 4 4 4 4 4 4 4 4
4 4 4 4 4 0 0 0 0 0 0 0 0 0 0 0 2 2 2 2 2 2 2 2 2 2 2 2 2 0 0 0 0 0 0 0 0 0 4 4 4 4 4 4 4 4 4 4 4 4
4 4 4 4 4 0 0 0 0 0 0 0 0 0 2 2 2 2 2 2 2 2 2 2 2 2 2 2 2 0 0 0 0 0 0 0 0 4 4 4 4 4 4 4 4 4 4 4 4 4
4 4 4 4 4 0 0 0 0 0 0 0 0 2 2 2 2 2 2 2 2 2 2 2 2 2 2 2 0 0 0 0 0 0 0 0 4 4 4 4 4 4 4 4 4 4 4 4 4 4
4 4 4 4 4 4 0 0 0 0 0 0 2 2 2 2 2 2 2 2 2 2 2 2 2 2 2 0 0 0 0 0 0 0 0 0 4 4 4 4 4 4 4 4 4 4 4 4 4 4
4 4 4 4 4 4 0 0 0 0 0 2 2 2 2 2 2 2 2 2 2 0 0 0 0 0 0 0 0 0 0 0 0 0 0 0 4 4 4 4 4 4 4 4 4 4 4 4 4 4
4 4 4 4 4 4 0 0 0 0 2 2 2 2 2 2 2 2 2 2 0 0 0 0 0 0 0 0 0 0 0 0 0 0 4 4 4 4 4 4 4 4 4 4 4 4 4 4 4 4
4 4 4 4 4 4 0 0 0 2 2 2 2 2 2 2 2 2 2 2 0 0 0 0 0 0 0 0 0 0 0 0 0 4 4 4 4 4 4 4 4 4 4 4 4 4 4 4 4 4
4 4 4 4 4 0 0 0 2 2 2 2 2 2 2 2 2 2 2 2 0 0 0 0 0 0 0 0 0 0 0 0 0 4 4 4 4 4 4 4 4 4 4 4 4 4 4 4 4 4
4 4 4 0 0 0 0 0 2 2 2 2 2 2 2 2 2 2 2 0 0 0 0 0 0 0 0 0 0 0 0 0 0 4 4 4 4 4 4 4 4 4 4 4 4 4 4 4 4 4