21 21 21 21 21 21 21 21 18 22 22 22 22 22 22 22 22 22 22 22 22 22 22 22 22 22 22 22 22 22 22 22 18 18 20 20 20 20 20 20 20 20 20 20 23 23 23 23 23 23
21 17 17 17 17 17 17 21 18 22 22 22 22 22 22 22 22 22 22 22 22 22 22 22 22 22 22 22 22 22 22 22 18 18 20 20 20 20 20 20 20 20 20 20 23 23 23 23 23 23
21 17 17 17 17 17 17 21 18 22 22 22 22 22 22 22 22 22 22 22 22 22 22 22 22 22 22 22 22 22 22 22 18 18 20 20 20 20 20 20 20 20 20 20 23 23 23 23 23 23
21 17 17 17 17 17 17 21 18 18 22 22 22 22 22 22 18 18 19 15 22 22 22 22 22 22 22 22 22 22 22 22 18 18 20 20 20 20 20 20 20 20 20 23 23 23 23 23 23 23
21 17 17 17 17 17 17 21 18 18 22 22 22 22 22 18 19 18 18 18 18 22 22 22 22 22 22 22 22 22 22 22 18 18 20 20 20 20 20 20 20 20 23 23 23 23 23 23 23 23
21 17 17 17 17 17 17 21 18 18 22 22 22 22 22 18 18 18 18 18 19 22 22 22 22 22 22 22 22 22 22 22 18 18 20 20 20 20 20 20 20 20 20 23 23 23 23 20 20 20
21 17 17 17 17 17 17 21 18 18 22 22 22 22 19 18 18 18 18 18 19 22 22 22 22 22 22 22 22 22 22 22 18 18 20 20 20 20 20 20 20 20 20 23 23 23 23 20 20 20
21 17 17 17 17 17 17 21 18 18 22 22 22 22 15 19 18 18 18 22 22 22 22 22 22 22 22 22 22 22 22 18 18 23 20 20 20 20 20 20 20 20 20 23 23 23 20 20 20 20
21 21 21 21 17 21 21 21 18 18 18 22 22 22 22 18 19 18 18 22 22 22 22 22 22 22 22 22 22 22 18 18 23 23 23 20 20 20 20 20 20 20 20 20 20 20 20 20 20 20
18 21 17 17 17 17 21 18 18 18 18 22 22 22 22 22 22 18 18 22 22 22 22 22 22 22 22 22 18 18 23 23 23 23 23 23 23 20 20 20 20 20 20 20 20 20 20 20 20 20
18 21 17 17 17 17 21 18 18 18 18 22 22 22 22 22 22 19 22 22 22 22 22 22 22 22 18 18 18 18 23 23 23 23 23 23 23 20 20 20 20 20 20 20 20 20 20 20 20 20
18 21 17 17 17 17 21 18 18 18 18 18 18 18 22 22 22 18 22 22 22 22 22 22 22 18 18 15 18 23 23 23 23 23 23 23 23 20 20 20 20 20 20 20 20 20 20 20 20 20
18 21 17 17 17 17 21 18 18 18 18 18 18 18 18 18 18 18 18 22 22 22 22 22 18 18 18 18 18 23 23 23 23 23 23 23 23 20 20 20 20 20 20 20 20 20 20 20 20 20
18 21 17 17 17 17 21 18 18 18 18 18 18 18 18 18 18 18 18 22 22 22 22 22 18 18 18 18 18 23 23 23 23 23 23 23 23 20 20 20 20 20 20 20 20 20 20 20 18 18
18 21 21 21 17 21 21 18 18 18 18 18 18 18 18 18 18 18 15 18 18 18 18 18 18 18 18 18 23 23 23 23 23 23 23 23 23 18 20 20 20 20 20 20 20 20 20 18 18 18
18 18 18 18 18 18 18 18 18 18 18 18 18 18 18 18 18 18 18 18 18 18 18 18 18 18 18 18 23 23 23 23 23 23 23 23 18 18 18 20 20 20 20 20 20 20 20 18 18 18
18 18 18 18 18 18 18 18 18 18 18 18 18 18 18 18 18 18 18 18 18 18 18 18 18 18 18 18 23 23 23 23 23 23 23 23 18 18 18 20 20 20 20 20 20 20 20 22 22 22
15 18 18 18 18 18 18 18 18 18 18 18 18 18 18 18 18 18 18 18 18 18 18 18 18 18 18 23 23 23 23 23 23 23 23 23 18 18 18 18 20 20 20 20 20 20 20 22 22 22
18 18 18 18 18 18 18 18 18 18 18 18 18 18 18 18 18 18 18 18 18 18 18 18 18 18 18 23 23 23 23 23 23 23 23 23 18 18 18 18 18 18 18 18 18 18 18 22 22 22
18 18 18 18 18 18 18 18 18 18 18 18 18 18 18 18 18 18 18 18 18 18 18 18 18 18 18 23 23 23 23 23 23 23 23 23 18 18 18 18 18 18 18 18 18 18 18 22 22 22
18 18 18 18 18 18 18 18 18 18 18 18 15 18 18 18 18 18 15 18 18 15 15 18 18 18 23 23 23 23 23 23 23 23 23 23 18 18 18 18 18 18 18 18 18 18 18 22 22 22
18 18 18 18 18 18 18 18 18 18 18 18 18 18 18 18 18 18 18 18 18 18 18 18 18 18 23 23 23 23 23 23 23 23 23 23 18 18 18 18 18 18 18 18 18 18 18 22 22 22
18 18 18 18 18 15 15 18 18 18 18 18 18 18 18 18 18 18 18 18 18 18 18 18 19 19 19 23 23 23 23 23 23 23 23 23 18 18 18 18 18 18 15 18 18 18 18 22 22 22
18 18 18 18 18 18 18 18 18 18 18 18 18 18 18 18 18 15 18 18 18 18 18 18 19 19 19 19 19 19 23 23 23 23 23 23 18 18 18 18 18 18 18 18 18 18 18 22 22 22
18 18 18 18 18 18 18 18 18 18 18 18 18 18 18 18 18 15 18 18 18 18 18 18 23 19 19 19 19 19 23 23 23 23 23 23 18 18 18 18 18 18 18 18 18 18 22 22 22 22
18 18 18 18 18 18 18 18 18 18 18 18 18 18 18 18 18 18 18 18 18 18 18 23 23 23 23 19 19 19 19 19 19 23 23 23 18 18 18 18 18 18 18 18 18 18 22 22 22 22
18 18 15 15 15 15 18 18 18 18 18 18 18 18 18 18 18 18 18 18 18 18 23 23 23 23 23 23 19 19 19 19 19 19 23 18 18 18 18 18 18 18 18 18 18 18 22 22 22 22
18 18 18 18 18 18 18 18 15 15 18 18 18 18 18 18 18 18 18 18 23 23 23 23 23 23 23 23 23 23 19 19 19 19 19 18 18 18 18 18 18 15 18 18 18 22 22 22 22 22
18 18 18 18 18 18 18 18 18 18 18 18 18 18 18 18 18 18 23 23 23 23 23 23 23 23 23 23 23 23 23 23 23 19 19 18 18 18 18 15 18 18 18 18 22 22 22 22 22 22
18 18 18 18 18 18 18 18 18 18 18 18 18 18 18 18 23 23 23 23 23 23 23 23 23 23 23 23 23 23 23 23 23 23 18 18 18 18 18 18 18 18 18 18 22 22 22 22 22 22
18 18 18 18 18 18 18 18 18 18 18 18 18 18 18 23 23 23 23 23 23 23 23 23 23 23 23 23 23 23 23 23 23 18 18 18 18 18 18 18 18 18 18 18 22 22 22 22 22 22
18 18 18 20 20 20 20 20 20 18 18 18 18 18 23 23 23 23 23 23 23 23 23 23 23 23 23 23 23 23 23 23 23 18 18 18 18 18 18 18 18 18 18 18 22 22 22 22 22 22
18 20 20 20 20 20 20 20 20 18 18 18 23 23 23 23 23 23 23 23 23 23 23 23 23 23 23 23 23 23 23 23 23 18 18 18 18 18 18 18 18 15 18 18 22 22 22 22 22 22
18 20 20 20 20 20 20 20 20 18 18 23 23 23 23 23 23 23 23 23 23 23 23 23 23 23 23 23 23 23 23 23 18 18 18 15 18 18 18 18 18 18 18 18 22 22 22 22 22 22
20 20 20 20 20 20 20 20 20 18 23 23 23 23 23 23 23 23 23 23 23 23 23 23 23 23 23 23 23 23 23 18 18 18 18 18 18 18 18 18 18 18 18 22 22 22 22 22 22 22
20 20 20 20 20 20 20 20 20 23 23 23 23 23 23 23 23 23 23 23 23 23 23 23 23 23 23 23 23 23 18 18 18 18 18 18 18 18 18 18 18 18 22 22 22 22 22 22 22 22
20 20 20 20 20 20 20 20 20 23 23 23 23 23 23 23 23 23 23 23 23 23 23 23 23 23 23 23 23 18 18 18 18 18 18 18 18 18 18 18 22 22 22 22 22 22 22 22 22 22
20 20 20 20 20 20 20 20 20 23 23 23 23 23 23 23 23 23 23 23 23 23 23 23 23 23 23 18 18 18 18 15 15 18 18 18 18 18 18 22 22 22 22 22 22 22 22 22 22 22
20 20 20 20 20 20 20 20 20 23 23 23 23 23 23 20 20 20 20 20 20 20 20 23 18 18 18 15 18 18 18 18 18 18 18 18 18 18 22 22 22 22 22 22 22 22 22 22 22 22
20 20 20 20 20 20 20 20 23 23 23 23 23 23 20 20 20 20 20 20 20 20 20 18 18 18 18 15 18 18 18 18 18 18 18 18 18 22 22 22 22 22 22 22 22 22 22 22 22 22
20 20 20 20 20 20 20 23 23 23 23 23 23 23 20 20 20 20 20 20 20 20 20 18 18 18 18 18 18 18 18 18 18 18 18 18 22 22 22 22 22 22 22 22 22 22 22 22 22 22
20 20 20 20 20 20 23 23 23 23 23 23 23 23 20 20 20 20 20 20 20 20 20 18 18 18 18 18 18 18 18 18 18 18 22 22 22 22 22 22 22 22 22 22 22 22 22 22 22 22
20 20 20 20 20 23 23 23 23 23 23 23 23 23 20 20 20 20 20 20 20 20 20 18 18 18 15 18 18 18 18 18 18 22 22 22 22 22 22 22 22 22 22 22 22 22 22 22 22 22
20 20 20 23 23 23 23 23 23 23 23 23 23 20 20 20 20 20 20 20 18 18 18 18 18 18 15 18 18 18 18 18 22 22 22 22 22 22 22 22 22 22 22 22 22 22 22 22 22 22
23 23 23 23 23 23 23 23 23 23 23 23 20 20 20 20 20 20 20 18 18 18 18 18 18 18 18 18 18 18 18 22 22 22 22 22 22 22 22 22 22 22 22 22 22 22 22 22 22 22
23 23 23 23 23 23 23 23 23 20 20 20 20 20 20 20 20 20 20 18 18 18 18 18 18 18 18 18 18 22 22 22 22 22 22 22 22 22 22 22 22 22 22 22 22 22 22 22 22 22
23 23 23 23 23 23 20 20 20 20 20 20 20 20 20 20 20 20 20 18 18 18 18 18 18 18 18 22 22 22 22 22 22 22 22 22 22 22 22 22 22 22 22 22 22 22 22 22 22 22
23 23 23 23 20 20 20 20 20 20 20 20 20 20 20 20 20 20 20 18 18 18 18 18 18 22 22 22 22 22 22 22 22 22 22 22 22 22 22 22 22 22 22 22 22 22 22 22 22 22
23 23 23 23 20 20 20 20 20 20 20 20 20 20 20 20 20 20 18 18 18 18 18 18 18 22 22 22 22 22 22 22 22 22 22 22 22 22 22 22 22 22 22 22 22 22 22 22 22 22
23 23 23 23 20 20 20 20 20 20 20 20 20 20 20 20 18 18 18 18 18 18 18 18 18 22 22 22 22 22 22 22 22 22 22 22 22 22 22 22 22 22 18 22 22 22 22 22 22 22